NO ./sp/no.xpm
SO ./sp/so.xpm
WE ./sp/we.xpm
EA ./sp/ea.xpm


F 220,100,0			
C 225,30,0


11111 111111111111111111111111111
10001 111000000000110000000000001
1001  110110000011100000000000011
101111111100100000000000000000000111111111
10111111101100000111000S000000001
100000000011000001110111111111111
11110111111111011100000010001
11110111111111011101010010001
11000000110101011100000010001
10000000000000001100000010001
10000100000010001101010010001
11000001110101011111011110001
11110111111010110111101000111
11111111111111111111111111111
