NO
dsfg
asdw
asdqfesf


11111111111111
10000000N00001
10000N00000001
11111111111111
