NO
dsfg
asdw
asdqfesf
	













	11111111111111
1000000001111
10000000000001
10000N00000001
11111111111111
