NO
dsfg
asdw
asdqfesf


11111111111111
11000000000001
10000000000001
11111111111111
