NO ./img/no.xpm
SO ./img/so.xpm
WE ./img/we.xpm
EA ./img/ea.xpm


F 220,100,0			
C 225,30,0

11111111111111111111111111111
10000000000000000000000000001
11111000000000000000011111111
10000000000000111110000000001
10000000000000000000000000001
10000011100000000N00000000001
10000000000000000000000000001
10000000000000000001111000001
10000000000000000000000000001
10000011110000000000000000001
10000000000000000001111000001
10000000000000001000000000001
10000000000000000000000000001
11111111111111111111111111111
