NO ./sp/no.xpm
SO ./sp/so.xpm
WE ./sp/we.xpm
EA ./sp/ea.xpm


F 220,100,0			
C 225,0,111

11111111111111111111111111111
10000000000000000N00000000001
11111000000000000000011111111
10000000000000111110000000001
10000000000000000000000000001
10000011101000000000000000001
1000000001 100000000000000001
10000000001000000001111000001
10000000000000000000000000001
10000011110000000000000000001
10000000000000000001111000001
10000000000000001000000000001
10000000000000000000000000001
11111111111111111111111111111
